"assignee_member_number","member_id","member_name"
"1001","",""
"1002","",""
"1003","",""
"1004","",""
"1005","",""
"1006","",""
"1011","",""
"1012","",""
"1010","",""
